1111111111111111
1P00000C0C000001
1C00000000000001
100CC00000000001
1111111110111111
10000000000000C1
1001001001001001
1000C000000000E1
1111111111111111